一	yī
二	èr
三	sān
四	sì
五	wǔ
六	liù
七	qī
八	bā
九	jiǔ
十	shí
人	rén
大	dà
小	xiǎo
上	shàng
下	xià
中	zhōng
左	zuǒ
右	yòu
前	qián
后	hòu
来	lái
去	qù
进	jìn
出	chū
开	kāi
关	guān
门	mén
窗	chuāng
桌	zhuō
椅	yǐ
书	shū
笔	bǐ
纸	zhǐ
水	shuǐ
火	huǒ
山	shān
石	shí
土	tǔ
木	mù
金	jīn
日	rì
月	yuè
星	xīng
云	yún
雨	yǔ
雪	xuě
风	fēng
雷	léi
电	diàn
天	tiān
地	dì
春	chūn
夏	xià
秋	qiū
冬	dōng 